10 8
# # # # # # # # # #
# T # # # # # # # #
# . . . . # . . . #
# . # . . # . # # #
# . . B . . . . . #
# # # . . # # # . #
# S . . . . . . . #
# # # # # # # # # #
