6 6
# # # # # # #
# T . . # # #
# . # B . # #
# . . . . . #
# . . . . S #
# # # # # # #

